NO ./assets/no.png
WE ./assets/we.png
SO ./assets/so.png
EA ./assets/ea.png
F 255,0,0
C 200,8,8

11111111111111
1            1
1    0000    1
1    0N00    1
1    0000    1
1    0000    1
1            
11111111111111
