NO./path

SO 23124


EA shit

WE                     ok

F

C


111111
100001
100001
1N1111
1111
11
1




shit!!!
