NO ./assets/no
WE ./assets/we
SO ./assets/so
EA ./assets/ea
F 255,0,0
C 200,8,8

111111111   00000
1000N0001   01110
111111111   00000

0000000
000000
00000
0000
000
00
0
