NO ./assets/no.png
WE ./assets/we.png
SO ./assets/so.png
EA ./assets/ea.png
F 66, 110, 65
C 142, 191, 187
DO ./assets/door.png



111111111111111
100000000000001
1000000S0000001
100000000000001
100000000000001
100000000000001
100000000000001
1111111D1111111
