NO ./assets/Tile_11.png
WE ./assets/Tile_06.png
SO ./assets/Tile_08.png
EA ./assets/Stone_03.png
F 110,130,110
C 150,170,255

111111111111111111
100000000000000001
100000000000000001
10011D1100000$0001
100$00000000000001
1000000 0000000001
100000000000000001
10000N000000000001
100000000000000001
100000000000000001
100000000000000001
100000000000000001
100000000000000001
100011000000000001
100000110000000001
100000000000000001
100000000000000001
100000000000000001
100000000000000001
100000011111111111
10000001
10000001
10000001
11111111
