NO ./assets/doom_6.png
WE ./assets/doom_21.png
SO ./assets/doom_17.png
EA ./assets/doom_19.png
DO ./assets/doom_27.png
F 110,130,110
C 150,170,255

111111111111111111
100000000000000001
100000000000000001
100111D11111111111
100000E00000000001
100111D11111111001
100000000000001001
100000000000001001
111D11001111001001
100001001001001001
100001001001001001
10000D00100D001001
100001001001001001
100001001001001001
1000011110011D1001
100000000000000011
100111111111111111
100000000000000011
100000000000000001
100000000000000001
111D11111111111111
10000001
10000001
10000001
11111111
