
NO ./assets/doom_1.png
SO ./assets/doom_13.png
WE ./assets/doom_2.png
EA ./assets/doom_14.png
DO ./assets/doom_17.png
F 110,130,110
C 150,170,255

111111111111111111
1 00000000 00000 1
100000000000000001
100111D11D11111111
100000000000000001
100111D1D1D1111001
1000000000000000 1
100000N00010000111
1000000000D0000001
100000000010000001
1 00000000D00000 1
111111111111111111
