NO ./assets/tile_5.png
    WE ./assets/tile_4.png
        SO ./assets/tile_3.png
			EA ./assets/tile_6.png
		F 66, 110, 65
	C 142,191,147

111111111
100000001
1000S0001
100000001
111111111
