NO ./assets/tile_0.png
WE ./assets/tile_1.png
SO ./assets/tile_2.png
EA ./assets/tile_3.png
F 66, 110, 65
C 142,191,147

111111111
100000001
1000N0001
100000001
111111111
