NO./assets/no
WE./assets/we
SO./assets/so
EA./assets/ea

F +255,0,0
C +255,0,0

111111111
1000N0001
111111111
