NO ./assets/no.png
WE ./assets/we.png
SO ./assets/so.png
EA ./assets/ea.png
F 110,130,110
C 150,170,255

111111111111111111111111111
10S100000000000000000000001
1001001 1000000000000000001
1001001 1111111111111111001
1001001 1000000000000000001
100100101000000000001111111
100100101001111111111000001
100100101001011000000000001
100000101001011000000000001
111111111001000000000000001
100000000000000000000000001
100000000000000000000000001
100000000000000000000000001
100011000000000000000000001
100000110000000000000000001
100000000000000000000000001
100000000000000000000000001
100000000000000000000000001
100000000000000000000000001
100000000000001111111110001
100000000000000000000000001
100000000000000000000000001
100000000000000000000000001
111111111111111111111111111
