NO./assets/tile_13.png
WE./assets/tile_12.png
SO./assets/tile_14.png
EA./assets/tile_15.png

F +66,+110,+65
C +142,+191,+147

111111111
100000001
1000S0001
100000001
111111111
