NO ./assets/no
WE ./assets/we
SO ./assets/so
EA ./assets/ea
F 255,0,0
C 200,8,8



         111111
11111111110000011111
11100000000001111111111111
  111111000000000000111
      11110000N0000011
      1111    0      1               
      1111    0     11    
      1111    0     111
      11111100000111111
      11111110001111111
0            101
00           101
000          101
0000          1
