NO ./assets/no.png
WE ./assets/we.png
SO ./assets/so.png
EA ./assets/ea.png
F 66, 110, 65
C 142, 191, 187


1111111111111111111111
1000000000 N0000000001
1111111111111111111111    1111111111111111111111
                          11110 0 0 0 0 0 0 1111
1111111111111111111111    1111111111111111111111
10 0 0 0 0 0 0 0 0 0 1
1111111111111111111111
