NO ./assets/no
WE ./assets/we
SO ./assets/so
EA ./assets/ea
F 255,0,0
C 200,8,8


1111111111111111111111
10000000   N   0000001
1111111111111111111111    1111111111111111111111
                          11110 0 0 0 0 0 0 1111
1111111111111111111111    1111111111111111111111
10 0 0 0 0 0 0 0 0 0 1
1111111111111111111111
