NO ./assets/egypt_0.png
WE ./assets/egypt_1.png
SO ./assets/egypt_2.png
EA ./assets/egypt_3.png
C 128,170,255
F 194, 178,128

1111100000000000
11  1    0000000
11  1    0000000
11  1    1111111
11  1    1  N  1
0000111111111111
