NO ./assets/no.png
WE ./assets/we.png
SO ./assets/so.png
EA ./assets/ea.png
F 66, 110, 65
C 142, 191, 187

111111111111111
1 00000000000 1
1000000N0000001
1 00000000000 1
111111111111111
