
NO  ./assets/doom_12.png
SO  ./assets/doom_16.png
WE  ./assets/doom_20.png
EA  ./assets/doom_34.png
DO  ./assets/doom_15.png
F			0,0,0
C			150,0,0


                 1
                 1
                111
                111
               11 11
               11011
               11011
              1100011
              1100011
              1100011
             110000011
            11000000011
11111111111111111D1111111111111111111
 11111111111111110111111111111111111
  11  00000011 00000 110000000  111
   1110000011 0000000 1100000011
    11100000D0000000000D00000011
      1110011000000000010000111
       1111110000N000001100111
        111110000000000111111
         111110000000011111
         111111000000111111
         11100D000000D00111
         11000111  11100011
         100000111110000111
        11000001111100000111
       1100000011  1110000111
       110000011    111000011
      110000111      111000011
      1100011          1100011
      110011            110011
     11  11               11  11
    111111                 111111
    1111                     1111
   1111                       1111
   11                           11
