NO ./assets/doom_0.png
WE ./assets/doom_1.png
SO ./assets/doom_2.png
EA ./assets/doom_3.png
DO ./assets/doom_15.png
C 139, 1, 1
F 10, 10, 10



11111111111  11111111111  11111111111  11111111111  11111111111  11111111111  11111111111
 100   001    100   001    100   001    100   001    100   001    100   001    100   001
  1000001      1000001      1000001      1000001      1000001      1000001      1000001
   10001        10001        10001        10001        10001        10001        10001
   10001        10001        10001        10001        10001        10001        10001
   10001        10001        10001        10001        10001        10001        10001
   10001        10001        10001        10001        10001        10001        10001
   10001        10001        10001        10001        10001        10001        10001
   10001        10001        10001        10001        10001        10001        10001
    1D1          1D1          1D1          1D1          1D1          1D1          1D1
    101          101          101          1D1          101          101          101
    101          101          101          1D1          101          101          101
    101          101          101          1D1          101          101          101
    1001         1001         1001        10001        1001         1001         1001
     1001         1001         1001       10001       1001         1001         1001
      1001         1001         1001      10001      1001         1001         1001
       1001         1001         1001     10001     1001         1001         1001
        1001         1001         1001    10001    1001         1001         1001
         1001         1001         1001   10001   1001         1001         1001
          1001         1001         1001  10001  1001         1001         1001
           1001         1001         1001 10001 1001         1001         1001
            1001         1001         1001100011001         1001         1001
             1001         1001         10000000001         1001         1001
              1D11    1    1D11    11   100000001   11    11D1    1    11D1
              10001   1    1001    11    1000001    11    1001    1   10001
              10001   1    1001    11    1000001    11    1001    1   10001
              10001        1001          1000001          1001        10001
               10001111111100001111111111111D11111111111110000111111110001
                100000000000000000000000000000000000000000000000000000001
                 1 0000000000000000000000000N0000000000000000000000000 1
                  11111111111011111111111100000111111111110111111111111
                   111111111101111111111111101111111111111011111111111
                    1111111110111111111111110111111111111101111111111
                     11111111011111111111111D11111111111110111111111
                      1111111 1111111111111000111111111111 11111111
                       1111111111111111111100011111111111111111111
                        11111111111111111110001111111111111111111
                         111111111111111111000111111111111111111
                          1111111111111111100011111111111111111
                           11111111111111110001111111111111111
                            111111111111111000111111111111111
                             1111111111111100011111111111111
                              11111111111110001111111111111
                               1111111111111D1111111111111
                                1111111100000000001111111
                                 11111110000000000111111
                                  111111000000000011111
                                   111100        00111
                                    11111111111111111
