NO ./assets/tile_12.png
WE ./assets/tile_6.png
SO ./assets/doom_4.png
EA ./assets/tile_16.png
DO ./assets/tile_13.png
F 34,130,7
C 111,54,255

            11111111111
            10000D000W1
            10000100001
            10000100001
            10000100001
11111111111110000000001111111111111
        1111111     1111111
            11111111111
                111
                 1
