NO ./assets/tile_0.png
WE ./assets/tile_10.png
SO ./assets/tile_15.png
EA ./assets/tile_20.png
F 66, 110, 65
C 142, 191, 187
DO ./assets/tile_9.png


11111111111111111111
1       1D1        1
1 0000000000000000 1
1 0000000000000000 1
1 0000000000000000 1
1 0000000N00000000 1
1 0000000000000000 1
1 0000000000000000 1
1       1D1        1
11111111111111111111
