NO ./assets/tile_16.png
WE ./assets/tile_17.png
SO ./assets/tile_18.png
EA ./assets/tile_15.png
F 66, 110, 65
C 142, 191, 187
DO ./assets/tile_19.png

              000
       1D1    1D1   1D1
              000

       000    010    000
       000    0D0    000
       000    010    000
              111
       11111111D11111111
       10000000000000001
       10000001D10000001
       10000000N00000001
       11111111111111111

              000
       1D1    1D1    1D1
              000

       000    000    000
       000    000    000

            1D1D1D1
