NO ./assets/tile_5.png
WE ./assets/tile_6.png
SO ./assets/tile_7.png
EA ./assets/tile_8.png
F 66, 110, 65
C 142, 191, 187
DO ./assets/tile_9.png



    11111111111111111
    10000000S00000001
    10000000000000001
    1       0       1
    1       0       1
    1       0       1
    1       0       1
    11111111D11111111
    1 0000000000000 1
    11111111111111111
