NO ./assets/Tile_11.png
WE ./assets/Tile_06.png
SO ./assets/Tile_08.png
EA ./assets/Stone_03.png
DO ./assets/door.png
F 110,130,110
C 150,170,255

111111111111111111
100000000000000001
100000000000000001
10011D11100000001
100000000000000001
100000000000000001
100000000000000001
10011D111000000001
100000000000000001
10000000000000001
10000N000000000001
100000000000000001
100000000000000001
100011000000000001
100000110000000001
100000000000000001
100000000000000001
100000000000000001
100000000000000001
100000011111111111
10000001
10000001
10000001
11111111
