NO ./assets/no.png
WE ./assets/we.png
SO ./assets/so.png
EA ./assets/ea.png
F 66, 110, 65
C 142, 191, 187
DO ./assets/door.png

11111111111111111
10000000000000001
1000    D    0001
10000000N00000001
11111111111111111

       000
D      0D0      D
       000

000    000    000
000    000    000
000    000    000
000    000    000
000    000    000

       DDD


NO ./assets/no.png
WE ./assets/we.png
SO ./assets/so.png
EA ./assets/ea.png
F 66, 110, 65
C 142, 191, 187
DO ./assets/door.png



    11111111111111111
    10000000S00000001
    10000000000000001
    11111111D11111111
    11111111D11111111
    11111111D11111111
    11111111D11111111
    11111111D11111111
