NO ./assets/no.png
WE ./assets/we.png
SO ./assets/so.png
EA ./assets/ea.png
F 66, 110, 65
C 142, 191, 187
DO ./assets/door.png


    111111111111111111
    10001D1D1D1D100001
    100000000000000001
    100000000000000001
    10000000N000000001
    10000000000000 001
    10 0000000000000 1
    111111111111111111
