NO ./assets/egypt_0.png
WE ./assets/egypt_1.png
SO ./assets/egypt_2.png
EA ./assets/egypt_3.png
DO ./assets/egypt_4.png
C 128,170,255
F 194, 178,128


              1
             1 1
            10001
           1000001
          1 00000 1
         11111D11111
        10000 0 00001
       100000 0 000001
      10000000000000001
     1000000000000000001
    1111111111D1111111111
   1000000000 0 0000000001
  10000000000 0 00000000001
 1000000000000N0000000000001
11111111111111111111111111111
