NO ./assets/west_0.png
WE ./assets/west_1.png
SO ./assets/west_2.png
EA ./assets/west_3.png
DO ./assets/west_4.png
C 128,170,255
F 194, 178,128

111111111111111111
100000000000     1
100000000000000001
10011D11100000001
100000000000000001
10  00000000000001
100000000000000001
10011D111000000001
100000000  0000001
10000000000000001
1    N000000000001
100000000000000001
100000000000000001
100011000000000001
100000110000  0001
100000000000000001
100000000000000001
100000000000000001
1000000   00000001
100000011111111111
10000001
10000001
10000001
11111111
